9399999999
9009090909
9099090909
9000090009
9909999909
9000000909
9099909009
9000900099
9090909009
9909999909
9000000909
9099909009
9000900099
9090909005
9999999999