9999999999
3009090909
9099090909
9000090005
9909999909
9000000909
9099909009
9000900099
9090909009
9999999999